{
  "name": "level1",
  "textureAtlas": "atlas.json",
  "tileEnum": {
    "box.png": 1,
    "castleCenter_rounded.png": 2
  },
  "grid": [
    [1,1,1,1,1,1,1,1,1,1,1,1,1,1,1,1],
    [1,0,0,0,0,0,0,0,0,0,0,0,0,0,0,1],
    [1,0,0,0,0,0,0,0,0,0,0,0,0,0,0,1],
    [1,0,0,0,0,0,0,0,0,0,0,0,0,0,0,1],
    [1,0,0,0,0,0,0,2,2,2,2,2,2,2,2,1],
    [1,0,0,0,0,0,0,0,0,2,0,0,0,2,2,1],
    [1,0,0,0,0,2,0,0,0,0,0,0,0,0,2,1],
    [1,0,0,0,2,2,0,0,0,0,0,0,0,0,0,1],
    [1,0,0,2,2,2,2,0,0,2,0,0,0,0,0,1],
    [1,1,1,1,1,1,1,1,1,1,1,1,1,1,1,1]
  ]
}